1111111111111111111111
1111111111111111123111
1111111111111111132111
1111111111111111111111
1111111111111111111111
1111111111111111111111
1111111111111111111111
1114556111111114611111
111b00711111111b711111
111b00711221111b711111
111a99811221111b711111
111111111111145c711111
1111111111111b00711111
1111111111111b00711111
1111111111111a99811111
1111111111111111111111
1111111111111111111111
1111111111111111111111
1111111111111111111111
1111111111111111111111
1111111111111111111111
1111111111111111111111